{
    "L0": "7",
    "L1": "1",
    "L2": "2",
    "L3": "3",
    "L4": "",
    "R0": "8",
    "R1": "4",
    "R2": "5",
    "R3": "6",
    "R4": ""
  }